111111111
1C0001001
100CP10E1
111111111
