11111111111
1P000000000
1C0000E0011
11111111000