111111111
1000P01E1
1000C0001
1P000C001
111111111