1111111111
10P10010C1
100C000001
1111111111