1111111111
100P100101
10000000E1
1111111111