1111111
1P000C1
1001E11
1111111